2 2 2 2 2 2 2 1 3 1 1 1 1 2 2 2
2 2 1 3 3 4 1 4 7 6 6 6 8 2 12 2
12 1 7 6 6 6 6 6 10 1 1 1 5 2 2 2
2 1 5 1 4 4 1 4 1 1 1 1 5 1 2 2
1 1 5 1 3 1 0 0 0 1 4 1 5 4 2 2
4 1 5 1 0 0 0 0 1 1 3 1 9 6 6 6
3 7 10 1 0 0 0 0 1 3 1 1 1 1 3 2
4 5 4 1 1 0 0 0 0 0 1 1 4 1 12 2
1 5 1 1 4 1 0 0 0 0 0 1 1 1 2 2
6 10 1 2 2 1 1 4 0 11 1 1 12 2 2 2
