0 0 0 0 0 0 0 1 3 1 1 1 1 0 0 0
0 0 1 3 3 4 1 4 7 6 6 6 8 0 0 0
0 1 7 6 6 6 6 6 10 1 1 1 5 0 0 0
0 1 5 1 4 4 1 4 1 1 1 1 5 1 0 0
1 1 5 1 3 1 2 2 2 1 4 1 5 4 11 0
4 1 5 1 2 2 2 2 1 1 3 1 9 6 6 6
3 7 10 1 2 2 2 2 1 3 1 1 1 1 3 0
4 5 4 1 1 2 12 2 2 2 1 1 4 1 0 0
1 5 1 1 4 1 2 2 2 2 2 1 1 1 0 0
6 10 1 0 0 1 1 4 2 12 1 1 0 0 0 0
